*****XX****X********XXXX
XX******XX***XXXXX**XXXX
XX***XXXX**XXXXX****XXXX
XX***XXXXXXXXXXXXXX****X
*****XXXXXX****XX***XXXX
XX*************XXXX*****
